,cur,est,actual,,,,,
2016-10-11,36400,35908.773,36700,791.2265625,491.227,-300,0,1
2016-10-12,36700,36364.746,35900,464.7460938,335.254,800,0,0
2016-10-13,35900,35711.38,36650,938.6210938,188.62,-750,0,1
2016-10-14,36650,36185.305,36950,764.6953125,464.695,-300,0,1
2016-10-17,36950,36710.727,37000,289.2734375,239.273,-50,0,1
2016-10-18,37000,36559.324,38850,2290.675781,440.676,-1850,0,1
2016-10-19,38850,38341.86,38700,358.140625,508.14,150,0,0
2016-10-20,38700,38691.44,39400,708.5585938,8.56,-700,0,1
2016-10-21,39400,38766.797,39500,733.203125,633.203,-100,0,1
2016-10-24,39500,38960.867,39050,89.1328125,539.133,450,0,0
2016-10-25,39050,38813.36,38000,813.359375,236.64,1050,0,0
2016-10-26,38000,37919.95,38550,630.0507813,80.05,-550,0,1
2016-10-27,38550,38140.547,37450,690.546875,409.453,1100,0,0
2016-10-28,37450,37320.84,37350,29.16015625,129.16,100,0,0
2016-10-31,37350,36966.78,35650,1316.78125,383.22,1700,0,0
2016-11-01,35650,35694.58,34650,1044.578125,-44.58,1000,1,0
2016-11-02,34650,34374.832,35250,875.1679688,275.168,-600,0,1
2016-11-03,35250,34870.66,34700,170.6601563,379.34,550,0,0
2016-11-04,34700,34608.2,35150,541.8007813,91.8,-450,0,1
2016-11-07,35150,34786.223,35250,463.7773438,363.777,-100,0,1
2016-11-08,35250,34741.55,33950,791.5507813,508.45,1300,0,0
2016-11-09,33950,33643.246,34850,1206.753906,306.754,-900,0,1
2016-11-10,34850,34319.008,35400,1080.992188,530.992,-550,0,1
2016-11-11,35400,34975.574,36450,1474.425781,424.426,-1050,0,1
2016-11-14,36450,36108.703,36400,291.296875,341.297,50,0,0
2016-11-15,36400,36086.863,36800,713.1367188,313.137,-400,0,1
2016-11-16,36800,36539.766,37400,860.234375,260.234,-600,0,1
2016-11-17,37400,37166.305,35900,1266.304688,233.695,1500,0,0
2016-11-18,35900,36051.293,35600,451.2929688,-151.293,300,1,0
2016-11-21,35600,35506.73,35750,243.2695313,93.27,-150,0,1
2016-11-22,35750,35516.816,36150,633.1835938,233.184,-400,0,1
2016-11-23,36150,35961.254,35600,361.2539063,188.746,550,0,0
2016-11-24,35600,35748.855,35100,648.8554688,-148.855,500,1,0
2016-11-25,35100,34857.914,35100,242.0859375,242.086,0,0,0
2016-11-28,35100,34710.605,35350,639.3945313,389.395,-250,0,1
2016-11-29,35350,35086.117,35300,213.8828125,263.883,50,0,0
2016-11-30,35300,34883.797,35150,266.203125,416.203,150,0,0
2016-12-01,35150,35018.934,35250,231.0664063,131.066,-100,0,1
2016-12-02,35250,34641.184,35050,408.8164063,608.816,200,0,0
2016-12-05,35050,34616.47,35550,933.53125,433.53,-500,0,1
2016-12-06,35550,35044.32,35400,355.6796875,505.68,150,0,0
2016-12-07,35400,35017.336,36250,1232.664063,382.664,-850,0,1
2016-12-08,36250,35757.637,35400,357.6367188,492.363,850,0,0
2016-12-09,35400,35183.605,35950,766.3945313,216.395,-550,0,1
2016-12-12,35950,35632.973,36650,1017.027344,317.027,-700,0,1
2016-12-13,36650,36215.582,36300,84.41796875,434.418,350,0,0
2016-12-14,36300,36055.184,36600,544.8164063,244.816,-300,0,1
2016-12-15,36600,36142.637,36050,92.63671875,457.363,550,0,0
2016-12-16,36050,35893.594,35400,493.59375,156.406,650,0,0
2016-12-19,35400,35256.297,35350,93.703125,143.703,50,0,0
2016-12-20,35350,35039.883,35550,510.1171875,310.117,-200,0,1
2016-12-21,35550,35250.824,35300,49.17578125,299.176,250,0,0
2016-12-22,35300,34982.637,35100,117.3632813,317.363,200,0,0
2016-12-23,35100,34826.57,35350,523.4296875,273.43,-250,0,1
2016-12-26,35350,35119.184,35150,30.81640625,230.816,200,0,0
2016-12-27,35150,34814.875,35050,235.125,335.125,100,0,0
2016-12-28,35050,34584.094,35050,465.90625,465.906,0,0,0
2016-12-29,35050,34695.477,35450,754.5234375,354.523,-400,0,1
2017-01-02,35450,35054.02,36600,1545.980469,395.98,-1150,0,1
2017-01-03,36600,36210.637,37150,939.3632813,389.363,-550,0,1
2017-01-04,37150,36705.56,36750,44.44140625,444.44,400,0,0
2017-01-05,36750,36373.062,36700,326.9375,376.938,50,0,0
2017-01-06,36700,36291.027,36700,408.9726563,408.973,0,0,0
2017-01-09,36700,36371.312,37600,1228.6875,328.688,-900,0,1
2017-01-10,37600,37066.645,37400,333.3554688,533.355,200,0,0
2017-01-11,37400,37385.684,37950,564.3164063,14.316,-550,0,1
2017-01-12,37950,37501.63,37250,251.6289063,448.37,700,0,0
2017-01-13,37250,36998.047,36800,198.046875,251.953,450,0,0
2017-01-16,36800,36448.008,37200,751.9921875,351.992,-400,0,1
2017-01-17,37200,36893.426,36900,6.57421875,306.574,300,0,0
2017-01-18,36900,36643.926,36650,6.07421875,256.074,250,0,0
2017-01-19,36650,36385,36750,365,265,-100,0,1
2017-01-20,36750,36404.152,36700,295.8476563,345.848,50,0,0
2017-01-23,36700,36428.59,35550,878.5898438,271.41,1150,0,0
2017-01-24,35550,35296.01,35200,96.01171875,253.99,350,0,0
2017-01-25,35200,34960.41,35500,539.5898438,239.59,-300,0,1
2017-01-26,35500,35146.395,35200,53.60546875,353.605,300,0,0
2017-01-31,35200,34986.066,35750,763.9335938,213.934,-550,0,1
2017-02-01,35750,35292.004,35100,192.0039063,457.996,650,0,0
2017-02-02,35100,34921.46,35300,378.5390625,178.54,-200,0,1
2017-02-03,35300,35052.785,35050,2.78515625,247.215,250,0,0
2017-02-06,35050,34848.67,35600,751.328125,201.33,-550,0,1
2017-02-07,35600,35043.58,35250,206.421875,556.42,350,0,0
2017-02-08,35250,34884.04,35250,365.9609375,365.96,0,0,0
2017-02-09,35250,34851.78,35900,1048.21875,398.22,-650,0,1
2017-02-10,35900,35506.816,36100,593.1835938,393.184,-200,0,1
2017-02-13,36100,35753.465,35950,196.5351563,346.535,150,0,0
2017-02-14,35950,35653.05,36350,696.9492188,296.95,-400,0,1
2017-02-15,36350,35940,35650,290,410,700,0,0
2017-02-16,35650,35454.63,35500,45.37109375,195.37,150,0,0
2017-02-17,35500,35126.51,35500,373.4882813,373.49,0,0,0
2017-02-20,35500,35238.395,35800,561.6054688,261.605,-300,0,1
2017-02-21,35800,35355.55,35900,544.4492188,444.45,-100,0,1
2017-02-22,35900,35541.36,35450,91.359375,358.64,450,0,0
2017-02-23,35450,35204.99,36900,1695.011719,245.01,-1450,0,1
2017-02-24,36900,36565.41,36500,65.41015625,334.59,400,0,0
2017-02-27,36500,36310.22,36400,89.78125,189.78,100,0,0
2017-02-28,36400,35933.96,35800,133.9609375,466.04,600,0,0
2017-03-02,35800,35593.832,35950,356.1679688,206.168,-150,0,1
2017-03-03,35950,35752.59,35550,202.5898438,197.41,400,0,0
2017-03-06,35550,35191.516,36050,858.484375,358.484,-500,0,1
2017-03-07,36050,35684.176,35700,15.82421875,365.824,350,0,0
2017-03-08,35700,35447.207,35200,247.2070313,252.793,500,0,0
2017-03-09,35200,34970.61,35200,229.390625,229.39,0,0,0
2017-03-10,35200,34767.324,35350,582.6757813,432.676,-150,0,1
2017-03-13,35350,34986.94,35050,63.05859375,363.06,300,0,0
2017-03-14,35050,34888.59,34650,238.5898438,161.41,400,0,0
2017-03-15,34650,34436.734,34600,163.265625,213.266,50,0,0
2017-03-16,34600,34207.69,35400,1192.308594,392.31,-800,0,1
2017-03-17,35400,34894.723,35150,255.2773438,505.277,250,0,0
2017-03-20,35150,34862.242,35100,237.7578125,287.758,50,0,0
2017-03-21,35100,34750.527,35100,349.4726563,349.473,0,0,0
2017-03-22,35100,34715.38,35550,834.6210938,384.62,-450,0,1
2017-03-23,35550,35022.336,35650,627.6640625,527.664,-100,0,1
2017-03-24,35650,35273.402,35600,326.5976563,376.598,50,0,0
2017-03-27,35600,35263.06,36000,736.9414063,336.94,-400,0,1
2017-03-28,36000,35681.55,36150,468.4492188,318.45,-150,0,1
2017-03-29,36150,35835.33,35750,85.328125,314.67,400,0,0
2017-03-30,35750,35494.785,35900,405.2148438,255.215,-150,0,1
2017-03-31,35900,35639.06,35750,110.9414063,260.94,150,0,0
2017-04-03,35750,35453.434,35700,246.5664063,296.566,50,0,0
2017-04-04,35700,35374.703,35900,525.296875,325.297,-200,0,1
2017-04-05,35900,35576.055,35900,323.9453125,323.945,0,0,0
2017-04-06,35900,35581.87,35800,218.1289063,318.13,100,0,0
2017-04-07,35800,35511.55,35150,361.5507813,288.45,650,0,0
2017-04-10,35150,34837.906,35200,362.09375,312.094,-50,0,1
2017-04-11,35200,34793.727,35050,256.2734375,406.273,150,0,0
2017-04-12,35050,34838.094,35100,261.90625,211.906,-50,0,1
2017-04-13,35100,34781.457,35350,568.5429688,318.543,-250,0,1
2017-04-14,35350,34939.76,35450,510.2382813,410.24,-100,0,1
2017-04-17,35450,35022.164,36500,1477.835938,427.836,-1050,0,1
2017-04-18,36500,35977.32,36450,472.6796875,522.68,50,0,0
2017-04-19,36450,36154.062,37350,1195.9375,295.938,-900,0,1
2017-04-20,37350,36780.543,38050,1269.457031,569.457,-700,0,1
2017-04-21,38050,37521.754,39200,1678.246094,528.246,-1150,0,1
2017-04-24,39200,38640.58,39250,609.421875,559.42,-50,0,1
2017-04-25,39250,38814.56,39700,885.4414063,435.44,-450,0,1
2017-04-26,39700,39562.652,40150,587.3476563,137.348,-450,0,1
2017-04-27,40150,39812.867,39950,137.1328125,337.133,200,0,0
2017-04-28,39950,39701.867,40050,348.1328125,248.133,-100,0,1
2017-05-02,40050,39871.613,40050,178.3867188,178.387,0,0,0
2017-05-04,40050,39917.38,41050,1132.621094,132.62,-1000,0,1
2017-05-08,41050,40705.156,41150,444.84375,344.844,-100,0,1
2017-05-10,41150,41197.875,42350,1152.125,-47.875,-1200,0,0
2017-05-11,42350,41846.67,42550,703.328125,503.33,-200,0,1
2017-05-12,42550,41970.703,42650,679.296875,579.297,-100,0,1
2017-05-15,42650,42129.383,43950,1820.617188,520.617,-1300,0,1
2017-05-16,43950,43251.34,44350,1098.660156,698.66,-400,0,1
2017-05-17,44350,43996.406,44150,153.59375,353.594,200,0,0
2017-05-18,44150,43700.32,45450,1749.679688,449.68,-1300,0,1
2017-05-19,45450,44857.11,45800,942.890625,592.89,-350,0,1
2017-05-22,45800,45727.473,46400,672.5273438,72.527,-600,0,1
2017-05-23,46400,46064.555,46400,335.4453125,335.445,0,0,0
2017-05-24,46400,46275.094,47450,1174.90625,124.906,-1050,0,1
2017-05-25,47450,47088.145,46200,888.1445312,361.855,1250,0,0
2017-05-26,46200,46384.89,48000,1615.109375,-184.89,-1800,0,0
2017-05-29,48000,47847.12,47850,2.87890625,152.88,150,0,0
2017-05-30,47850,47815.992,47850,34.0078125,34.008,0,0,0
2017-05-31,47850,47736.2,48750,1013.800781,113.8,-900,0,1
2017-06-01,48750,48072.26,49000,927.7382813,677.74,-250,0,1
2017-06-02,49000,48700.32,47500,1200.320313,299.68,1500,0,0
2017-06-05,47500,47674.4,48100,425.6015625,-174.4,-600,0,0
2017-06-07,48100,47862.258,47850,12.2578125,237.742,250,0,0
2017-06-08,47850,47635.29,48300,664.7109375,214.71,-450,0,1
2017-06-09,48300,48082.387,47150,932.3867188,217.613,1150,0,0
2017-06-12,47150,47144.94,48000,855.0585938,5.06,-850,0,1
2017-06-13,48000,47353.848,47600,246.1523438,646.152,400,0,0
2017-06-14,47600,47459.535,46350,1109.535156,140.465,1250,0,0
2017-06-15,46350,46164.223,46550,385.7773438,185.777,-200,0,1
2017-06-16,46550,46220.656,45150,1070.65625,329.344,1400,0,0
2017-06-19,45150,44968.137,45750,781.8632812,181.863,-600,0,1
2017-06-20,45750,45667.918,45700,32.08203125,82.082,50,0,0
2017-06-21,45700,45169.867,46250,1080.132813,530.133,-550,0,1
2017-06-22,46250,45702.62,46400,697.3789063,547.38,-150,0,1
2017-06-23,46400,46115.387,45300,815.3867188,284.613,1100,0,0
2017-06-26,45300,45057.816,47000,1942.183594,242.184,-1700,0,1
2017-06-27,47000,46240.5,47300,1059.5,759.5,-300,0,1
2017-06-28,47300,47256.99,47050,206.9882813,43.01,250,0,0
2017-06-29,47050,46738.023,47400,661.9765625,311.977,-350,0,1
2017-06-30,47400,46855.35,47650,794.6484375,544.65,-250,0,1
2017-07-03,47650,47356.062,46050,1306.0625,293.938,1600,0,0
2017-07-04,46050,46097.773,46100,2.2265625,-47.773,-50,0,0
2017-07-05,46100,45752.168,46450,697.8320313,347.832,-350,0,1
2017-07-06,46450,46183.895,46550,366.1054688,266.105,-100,0,1
2017-07-07,46550,46361.938,48500,2138.0625,188.062,-1950,0,1
2017-07-10,48500,47790.41,48300,509.5898438,709.59,200,0,0
2017-07-11,48300,47761.39,46700,1061.390625,538.61,1600,0,0
2017-07-12,46700,46399.91,47000,600.0898437,300.09,-300,0,1
2017-07-13,47000,46779.676,48800,2020.324219,220.324,-1800,0,1
2017-07-14,48800,48299.047,48650,350.953125,500.953,150,0,0
2017-07-17,48650,48649.496,47650,999.4960938,0.504,1000,0,0
2017-07-18,47650,47593.92,48100,506.078125,56.08,-450,0,1
2017-07-19,48100,47474.57,48600,1125.429688,625.43,-500,0,1
2017-07-20,48600,48039.2,48800,760.8007813,560.8,-200,0,1
2017-07-21,48800,48570,48400,170,230,400,0,0
2017-07-24,48400,48208.465,48750,541.5351563,191.535,-350,0,1
2017-07-25,48750,48405.312,47850,555.3125,344.688,900,0,0
2017-07-26,47850,47782.625,48750,967.375,67.375,-900,0,1
2017-07-27,48750,48281.668,47850,431.6679688,468.332,900,0,0
2017-07-28,47850,47606.25,48950,1343.75,243.75,-1100,0,1
2017-07-31,48950,48571.11,49600,1028.890625,378.89,-650,0,1
2017-08-01,49600,48993.824,49600,606.1757813,606.176,0,0,0
2017-08-02,49600,49409.633,48800,609.6328125,190.367,800,0,0
2017-08-03,48800,48229.777,48850,620.2226563,570.223,-50,0,1
2017-08-04,48850,48158.082,50000,1841.917969,691.918,-1150,0,1
2017-08-07,50000,49518.617,50600,1081.382812,481.383,-600,0,1
2017-08-08,50600,50461.438,50700,238.5625,138.562,-100,0,1
2017-08-09,50700,50404.203,50800,395.796875,295.797,-100,0,1
2017-08-10,50800,49957.43,51200,1242.570313,842.57,-400,0,1
2017-08-11,51200,50471.07,50700,228.9296875,728.93,500,0,0
2017-08-14,50700,50703.293,51600,896.7070313,-3.293,-900,0,0
2017-08-16,51600,51102.91,51400,297.0898438,497.09,200,0,0
2017-08-17,51400,51065.715,51700,634.2851562,334.285,-300,0,1
2017-08-18,51700,51165.703,50600,565.703125,534.297,1100,0,0
2017-08-21,50600,50520.508,51800,1279.492188,79.492,-1200,0,1
2017-08-22,51800,51750.285,52000,249.7148437,49.715,-200,0,1
2017-08-23,52000,51565.37,51400,165.3710938,434.63,600,0,0
2017-08-24,51400,51118.13,49200,1918.128906,281.87,2200,0,0
2017-08-25,49200,48890.117,49300,409.8828125,309.883,-100,0,1
2017-08-28,49300,49108.99,49350,241.0117187,191.01,-50,0,1
2017-08-29,49350,48896.797,49200,303.203125,453.203,150,0,0
2017-08-30,49200,48804.555,49150,345.4453125,395.445,50,0,0
2017-08-31,49150,49000.89,48650,350.890625,149.11,500,0,0
2017-09-01,48650,48284.44,47500,784.4414063,365.56,1150,0,0
2017-09-04,47500,47148.133,46450,698.1328125,351.867,1050,0,0
2017-09-05,46450,46285.21,47250,964.7890625,164.79,-800,0,1
2017-09-06,47250,46882.957,47300,417.0429688,367.043,-50,0,1
2017-09-07,47300,46906.445,47300,393.5546875,393.555,0,0,0
2017-09-08,47300,46875.387,47350,474.6132813,424.613,-50,0,1
2017-09-11,47350,46923.195,48200,1276.804688,426.805,-850,0,1
2017-09-12,48200,47599.938,48050,450.0625,600.062,150,0,0
2017-09-13,48050,47627.85,47050,577.8515625,422.15,1000,0,0
2017-09-14,47050,46893.13,47050,156.8710938,156.87,0,0,0
2017-09-15,47050,46550.85,46950,399.1484375,499.15,100,0,0
2017-09-18,46950,46714.17,46300,414.171875,235.83,650,0,0
2017-09-19,46300,46228.863,46900,671.1367188,71.137,-600,0,1
2017-09-20,46900,46679.734,46700,20.265625,220.266,200,0,0
2017-09-21,46700,46493.89,43600,2893.890625,206.11,3100,0,0
2017-09-25,43600,43204.344,43600,395.65625,395.656,0,0,0
2017-09-26,43600,43347.727,43650,302.2734375,252.273,-50,0,1
2017-09-27,43650,43527.477,44100,572.5234375,122.523,-450,0,1
2017-09-28,44100,43697.97,44000,302.03125,402.03,100,0,0
2017-09-29,44000,43787.312,46100,2312.6875,212.688,-2100,0,1
2017-10-10,46100,45002.113,46050,1047.886719,1097.887,50,0,0
2017-10-11,46050,45723.066,46000,276.9335938,326.934,50,0,0
2017-10-12,46000,45626.473,45800,173.5273438,373.527,200,0,0
2017-10-13,45800,45384.543,46850,1465.457031,415.457,-1050,0,1
2017-10-16,46850,46515.168,46250,265.1679688,334.832,600,0,0
2017-10-17,46250,46013.957,45100,913.9570312,236.043,1150,0,0
2017-10-18,45100,45167.957,45000,167.9570313,-67.957,100,1,0
2017-10-19,45000,44577.82,45500,922.1796875,422.18,-500,0,1
2017-10-20,45500,45290.938,46600,1309.0625,209.062,-1100,0,1
2017-10-23,46600,46523.52,47000,476.4804687,76.48,-400,0,1
2017-10-24,47000,46717.78,46400,317.78125,282.22,600,0,0
2017-10-25,46400,46092.418,45300,792.4179688,307.582,1100,0,0
2017-10-26,45300,45147.64,45400,252.359375,152.36,-100,0,1
2017-10-27,45400,45163.633,44400,763.6328125,236.367,1000,0,0
2017-10-30,44400,44444.94,44650,205.0585937,-44.94,-250,0,0
2017-10-31,44650,44453.246,44750,296.7539063,196.754,-100,0,1
2017-11-01,44750,44374.875,46050,1675.125,375.125,-1300,0,1
2017-11-02,46050,45266.8,45900,633.1992187,783.2,150,0,0
2017-11-03,45900,45508.72,44750,758.71875,391.28,1150,0,0
2017-11-06,44750,44536.234,45450,913.765625,213.766,-700,0,1
2017-11-07,45450,44887.73,44250,637.7304688,562.27,1200,0,0
2017-11-08,44250,44238.402,44100,138.4023438,11.598,150,0,0
2017-11-09,44100,44114.74,44000,114.7382813,-14.74,100,1,0
2017-11-10,44000,43924.65,41400,2524.648438,75.35,2600,0,0
2017-11-13,41400,41486.85,41150,336.8515625,-86.85,250,1,0
2017-11-14,41150,40954.555,41050,95.4453125,195.445,100,0,0
2017-11-15,41050,40855.27,41800,944.7304688,194.73,-750,0,1
2017-11-17,41800,41683.582,41300,383.5820313,116.418,500,0,0
2017-11-20,41300,41269.133,40800,469.1328125,30.867,500,0,0
2017-11-21,40800,40492.766,41150,657.234375,307.234,-350,0,1
2017-11-22,41150,40859.918,40500,359.9179688,290.082,650,0,0
2017-11-24,40500,40237.793,40300,62.20703125,262.207,200,0,0
2017-11-27,40300,40050.02,40300,249.9804688,249.98,0,0,0
2017-11-28,40300,39935.402,41400,1464.597656,364.598,-1100,0,1
2017-11-29,41400,40742.98,41500,757.0195313,657.02,-100,0,1
2017-11-30,41500,41248.41,40750,498.4101563,251.59,750,0,0
2017-12-01,40750,40450.605,41350,899.3945313,299.395,-600,0,1
2017-12-04,41350,40922.58,42050,1127.421875,427.42,-700,0,1
2017-12-05,42050,41645.656,41550,95.65625,404.344,500,0,0
2017-12-06,41550,41509.13,40750,759.1289063,40.87,800,0,0
2017-12-07,40750,40797.55,39750,1047.550781,-47.55,1000,1,0
2017-12-08,39750,39607.68,40000,392.3203125,142.32,-250,0,1
2017-12-11,40000,39490.496,39500,9.50390625,509.504,500,0,0
2017-12-12,39500,39388.117,41500,2111.882813,111.883,-2000,0,1
2017-12-13,41500,41010.336,40700,310.3359375,489.664,800,0,0
2017-12-14,40700,40664.08,41550,885.921875,35.92,-850,0,1
2017-12-15,41550,41191.363,42000,808.6367188,358.637,-450,0,1
2017-12-18,42000,41721.79,41900,178.2109375,278.21,100,0,0
2017-12-19,41900,41662.082,40500,1162.082031,237.918,1400,0,0
2017-12-21,40500,40332.31,40700,367.6914063,167.69,-200,0,1
2017-12-22,40700,40505.15,41000,494.8515625,194.85,-300,0,1
2017-12-26,41000,40673.074,41050,376.9257813,326.926,-50,0,1
2017-12-27,41050,40811.258,41500,688.7421875,238.742,-450,0,1
2017-12-28,41500,40893.953,43000,2106.046875,606.047,-1500,0,1
2018-01-03,43000,42810.387,43600,789.6132813,189.613,-600,0,1
2018-01-04,43600,43479.895,46400,2920.105469,120.105,-2800,0,1
2018-01-05,46400,46084.66,45700,384.6601563,315.34,700,0,0
2018-01-08,45700,45615.887,45850,234.1132813,84.113,-150,0,1
2018-01-09,45850,45704.52,46000,295.4804688,145.48,-150,0,1
2018-01-10,46000,45870.32,44850,1020.320313,129.68,1150,0,0
2018-01-11,44850,44812.867,44650,162.8671875,37.133,200,0,0
2018-01-12,44650,44384.32,45850,1465.679688,265.68,-1200,0,1
2018-01-15,45850,45740.133,45000,740.1328125,109.867,850,0,0
2018-01-16,45000,44753.64,45000,246.359375,246.36,0,0,0
2018-01-17,45000,44767.12,45000,232.8789063,232.88,0,0,0
2018-01-18,45000,44833.367,46600,1766.632813,166.633,-1600,0,1
2018-01-19,46600,46058.08,47000,941.921875,541.92,-400,0,1
2018-01-22,47000,46757.867,48050,1292.132813,242.133,-1050,0,1
2018-01-23,48050,47526.574,46700,826.5742188,523.426,1350,0,0
2018-01-24,46700,46540.08,46950,409.921875,159.92,-250,0,1
2018-01-25,46950,46324.535,46950,625.4648438,625.465,0,0,0
2018-01-26,46950,46283.168,48200,1916.832031,666.832,-1250,0,1
2018-01-29,48200,47654.99,47150,504.9882813,545.01,1050,0,0
2018-01-30,47150,47349.32,47050,299.3203125,-199.32,100,1,0
2018-01-31,47050,46462.414,47000,537.5859375,587.586,50,0,0
2018-02-01,47000,46555.35,46400,155.3515625,444.65,600,0,0
2018-02-02,46400,46497.3,45500,997.3007813,-97.3,900,1,0
2018-02-05,45500,45414,44400,1014,86,1100,0,0
2018-02-06,44400,44060.387,43700,360.3867187,339.613,700,0,0
2018-02-07,43700,43818.254,43500,318.2539063,-118.254,200,1,0
2018-02-08,43500,43486.805,43650,163.1953125,13.195,-150,0,1
2018-02-09,43650,43055.035,42900,155.0351563,594.965,750,0,0
2018-02-12,42900,42587.312,41850,737.3125,312.688,1050,0,0
2018-02-13,41850,41771.79,41750,21.7890625,78.21,100,0,0
2018-02-14,41750,41511.188,42800,1288.8125,238.812,-1050,0,1
2018-02-19,42800,42364.55,42500,135.4492188,435.45,300,0,0
2018-02-20,42500,42189.055,42800,610.9453125,310.945,-300,0,1
2018-02-21,42800,42442.38,42300,142.3789063,357.62,500,0,0
2018-02-22,42300,41614.668,43050,1435.332031,685.332,-750,0,1
2018-02-23,43050,42690.438,43600,909.5625,359.562,-550,0,1
2018-02-26,43600,43277.65,44900,1622.351563,322.35,-1300,0,1
2018-02-27,44900,44867.25,44150,717.25,32.75,750,0,0
2018-02-28,44150,43903.02,42950,953.0195313,246.98,1200,0,0
2018-03-02,42950,42496.785,42450,46.78515625,453.215,500,0,0
2018-03-05,42450,42136.418,42200,63.58203125,313.582,250,0,0
2018-03-06,42200,42272.14,41700,572.140625,-72.14,500,1,0
2018-03-07,41700,41517.47,41600,82.53125,182.53,100,0,0
2018-03-08,41600,41479.617,42450,970.3828125,120.383,-850,0,1
2018-03-09,42450,41877.6,42450,572.3984375,572.4,0,0,0
2018-03-12,42450,42160.03,41500,660.03125,289.97,950,0,0
2018-03-13,41500,41079.254,41000,79.25390625,420.746,500,0,0
2018-03-14,41000,40466.836,41100,633.1640625,533.164,-100,0,1
2018-03-15,41100,40696.785,41350,653.2148438,403.215,-250,0,1
2018-03-16,41350,40960.207,41250,289.7929688,389.793,100,0,0
2018-03-19,41250,40884.555,40450,434.5546875,365.445,800,0,0
2018-03-20,40450,40087.58,39300,787.578125,362.42,1150,0,0
2018-03-21,39300,38979.07,39700,720.9296875,320.93,-400,0,1
2018-03-22,39700,39427.484,38500,927.484375,272.516,1200,0,0
2018-03-23,38500,38382.844,38500,117.15625,117.156,0,0,0
2018-03-26,38500,38406.664,39850,1443.335938,93.336,-1350,0,1
2018-03-27,39850,39532.92,39600,67.078125,317.08,250,0,0
2018-03-28,39600,39480.176,39350,130.1757813,119.824,250,0,0
2018-03-29,39350,39183.766,39150,33.765625,166.234,200,0,0
2018-03-30,39150,38927.043,38750,177.0429688,222.957,400,0,0
2018-04-02,38750,38444.156,39400,955.84375,305.844,-650,0,1
2018-04-03,39400,38803.418,38200,603.4179688,596.582,1200,0,0
2018-04-04,38200,38081.58,38650,568.421875,118.42,-450,0,1
2018-04-05,38650,38320.45,38650,329.5507813,329.55,0,0,0
2018-04-06,38650,38270.832,38900,629.1679688,379.168,-250,0,1
2018-04-09,38900,38502.383,39100,597.6171875,397.617,-200,0,1
2018-04-10,39100,38771.66,39850,1078.339844,328.34,-750,0,1
2018-04-11,39850,39538.29,38950,588.2890625,311.71,900,0,0
2018-04-12,38950,38796.566,39650,853.4335938,153.434,-700,0,1
2018-04-13,39650,39117.605,38850,267.6054688,532.395,800,0,0
2018-04-16,38850,38652.234,38650,2.234375,197.766,200,0,0
2018-04-17,38650,38351.34,40100,1748.660156,298.66,-1450,0,1
2018-04-18,40100,39518.016,40100,581.984375,581.984,0,0,0
2018-04-19,40100,39937.703,41250,1312.296875,162.297,-1150,0,1
2018-04-20,41250,40586.63,41050,463.3710938,663.37,200,0,0
2018-04-23,41050,40666.766,41100,433.234375,383.234,-50,0,1
2018-04-24,41100,40727.68,40300,427.6796875,372.32,800,0,0
2018-04-25,40300,40099.36,40450,350.640625,200.64,-150,0,1
2018-04-26,40450,40295.266,40050,245.265625,154.734,400,0,0
2018-04-27,40050,39900.66,39950,49.33984375,149.34,100,0,0
2018-04-30,39950,39820.637,39400,420.6367188,129.363,550,0,0
2018-05-02,39400,39112.2,39200,87.80078125,287.8,200,0,0
2018-05-03,39200,38865.652,38500,365.6523438,334.348,700,0,0
2018-05-04,38500,38202.227,39200,997.7734375,297.773,-700,0,1
2018-05-08,39200,38879.832,39350,470.1679688,320.168,-150,0,1
2018-05-09,39350,39095.3,39400,304.6992188,254.7,-50,0,1
2018-05-10,39400,39122.977,41050,1927.023438,277.023,-1650,0,1
2018-05-11,41050,40298.93,41950,1651.070313,751.07,-900,0,1
2018-05-14,41950,41611.8,41300,311.8007813,338.2,650,0,0
2018-05-15,41300,40958.67,39700,1258.671875,341.33,1600,0,0
2018-05-16,39700,39281.742,38750,531.7421875,418.258,950,0,0
2018-05-17,38750,38421.062,39000,578.9375,328.938,-250,0,1
2018-05-18,39000,38902.504,38300,602.5039063,97.496,700,0,0
2018-05-21,38300,38392.133,37100,1292.132813,-92.133,1200,1,0
2018-05-23,37100,37194.613,36550,644.6132813,-94.613,550,1,0
2018-05-24,36550,36371.984,36400,28.015625,178.016,150,0,0
2018-05-25,36400,36203.438,36750,546.5625,196.562,-350,0,1
2018-05-28,36750,36442.664,36850,407.3359375,307.336,-100,0,1
2018-05-29,36850,36708.96,35800,908.9609375,141.04,1050,0,0
2018-05-30,35800,35652.42,36000,347.578125,147.58,-200,0,1
2018-05-31,36000,35371.805,35950,578.1953125,628.195,50,0,0
2018-06-01,35950,35510.793,35550,39.20703125,439.207,400,0,0
2018-06-04,35550,35310.49,35550,239.5117188,239.51,0,0,0
2018-06-05,35550,34987.74,36650,1662.261719,562.26,-1100,0,1
2018-06-07,36650,36092.12,36350,257.8789063,557.88,300,0,0
2018-06-08,36350,36202.56,36650,447.4414063,147.44,-300,0,1
2018-06-11,36650,36269.13,36100,169.1289063,380.87,550,0,0
2018-06-12,36100,35876.582,35250,626.5820313,223.418,850,0,0
2018-06-14,35250,35119.004,35350,230.9960938,130.996,-100,0,1
2018-06-15,35350,35213.82,34300,913.8203125,136.18,1050,0,0
2018-06-18,34300,34444.758,33650,794.7578125,-144.758,650,1,0
2018-06-19,33650,33554.242,33250,304.2421875,95.758,400,0,0
2018-06-20,33250,33088.06,31850,1238.058594,161.94,1400,0,0
2018-06-21,31850,31871.904,32100,228.0957031,-21.904,-250,0,0
2018-06-22,32100,31696.59,32800,1103.410156,403.41,-700,0,1
2018-06-25,32800,32665.146,32900,234.8535156,134.854,-100,0,1
2018-06-26,32900,32381.51,31550,831.5097656,518.49,1350,0,0
2018-06-27,31550,31403.973,31500,96.02734375,146.027,50,0,0
2018-06-28,31500,31094.857,31550,455.1425781,405.143,-50,0,1
2018-06-29,31550,31297.56,30700,597.5605469,252.44,850,0,0
2018-07-02,30700,30584.436,30800,215.5644531,115.564,-100,0,1
2018-07-03,30800,30528.504,30600,71.49609375,271.496,200,0,0
2018-07-04,30600,30348.516,30350,1.484375,251.484,250,0,0
2018-07-05,30350,30142.918,31350,1207.082031,207.082,-1000,0,1
2018-07-06,31350,30974.566,31350,375.4335938,375.434,0,0,0
2018-07-09,31350,31169.496,31600,430.5039063,180.504,-250,0,1
2018-07-10,31600,31413.44,31300,113.4394531,186.56,300,0,0
2018-07-11,31300,31029.076,30900,129.0761719,270.924,400,0,0
2018-07-12,30900,30747.047,31050,302.953125,152.953,-150,0,1
2018-07-13,31050,31013.305,30600,413.3046875,36.695,450,0,0
2018-07-16,30600,30426.752,30550,123.2480469,173.248,50,0,0
2018-07-17,30550,30201.393,30350,148.6074219,348.607,200,0,0
2018-07-18,30350,30169.46,30050,119.4609375,180.54,300,0,0
2018-07-19,30050,29936.754,31600,1663.246094,113.246,-1550,0,1
2018-07-20,31600,30927.615,31800,872.3847656,672.385,-200,0,1
2018-07-23,31800,31592.826,31550,42.82617187,207.174,250,0,0
2018-07-24,31550,31264.209,31800,535.7910156,285.791,-250,0,1
2018-07-25,31800,31475.787,31950,474.2128906,324.213,-150,0,1
2018-07-26,31950,31581.248,32200,618.7519531,368.752,-250,0,1
2018-07-27,32200,31855.27,32150,294.7304688,344.73,50,0,0
2018-07-30,32150,31782.164,32150,367.8359375,367.836,0,0,0
2018-07-31,32150,31951.477,32250,298.5234375,198.523,-100,0,1
2018-08-01,32250,31806.732,31900,93.26757813,443.268,350,0,0
2018-08-02,31900,31630.729,34000,2369.271484,269.271,-2100,0,1
2018-08-03,34000,33388.273,33400,11.7265625,611.727,600,0,0
2018-08-06,33400,33295.75,32900,395.75,104.25,500,0,0
2018-08-07,32900,32584.592,32950,365.4082031,315.408,-50,0,1
2018-08-08,32950,32638.102,32800,161.8984375,311.898,150,0,0
2018-08-09,32800,32595.902,33450,854.0976563,204.098,-650,0,1
2018-08-10,33450,33003.008,32300,703.0078125,446.992,1150,0,0
2018-08-13,32300,32276.469,32800,523.53125,23.531,-500,0,1
2018-08-14,32800,32158.053,31450,708.0527344,641.947,1350,0,0
2018-08-16,31450,31207.332,31400,192.6679688,242.668,50,0,0
2018-08-17,31400,31000.953,32200,1199.046875,399.047,-800,0,1
2018-08-20,32200,31718.523,32000,281.4765625,481.477,200,0,0
2018-08-21,32000,31842.11,31450,392.109375,157.89,550,0,0
2018-08-22,31450,31223.803,30500,723.8027344,226.197,950,0,0
2018-08-23,30500,30360.299,30750,389.7011719,139.701,-250,0,1
2018-08-24,30750,30341.756,31200,858.2441406,408.244,-450,0,1
2018-08-27,31200,30782.832,31350,567.1679688,417.168,-150,0,1
2018-08-28,31350,30930.682,32100,1169.318359,419.318,-750,0,1
2018-08-29,32100,31752.742,31750,2.7421875,347.258,350,0,0
2018-08-30,31750,31444.227,31850,405.7734375,305.773,-100,0,1
2018-08-31,31850,31449.969,31600,150.03125,400.031,250,0,0
2018-09-03,31600,31212.965,31600,387.0351563,387.035,0,0,0
2018-09-04,31600,31275.379,31500,224.6210938,324.621,100,0,0
2018-09-05,31500,31360.578,31400,39.421875,139.422,100,0,0
2018-09-06,31400,31175.51,31350,174.4902344,224.49,50,0,0
2018-09-07,31350,31001.299,31700,698.7011719,348.701,-350,0,1
2018-09-10,31700,31260.307,31200,60.30664063,439.693,500,0,0
2018-09-11,31200,31058.63,31400,341.3691406,141.37,-200,0,1
2018-09-12,31400,30911.293,30950,38.70703125,488.707,450,0,0
2018-09-13,30950,30806.19,32200,1393.810547,143.81,-1250,0,1
2018-09-14,32200,31753.824,31950,196.1757812,446.176,250,0,0
2018-09-17,31950,31682.238,31950,267.7617187,267.762,0,0,0
2018-09-18,31950,31407.492,31850,442.5078125,542.508,100,0,0
2018-09-19,31850,31439.99,31350,89.99023438,410.01,500,0,0
2018-09-20,31350,31006.7,31650,643.3007813,343.3,-300,0,1
2018-09-21,31650,31282.1,33250,1967.900391,367.9,-1600,0,1
2018-09-27,33250,32608.633,32800,191.3671875,641.367,450,0,0
2018-09-28,32800,32501.6,33000,498.4003906,298.4,-200,0,1
2018-10-01,33000,32559.135,33450,890.8652344,440.865,-450,0,1
2018-10-02,33450,33118.062,33400,281.9375,331.938,50,0,0
2018-10-04,33400,33068.062,33200,131.9375,331.938,200,0,0
2018-10-05,33200,32841.45,32400,441.4492188,358.55,800,0,0
2018-10-08,32400,32283.293,31350,933.2929688,116.707,1050,0,0
2018-10-10,31350,31242.676,28900,2342.675781,107.324,2450,0,0
2018-10-11,28900,28929.951,29100,170.0488281,-29.951,-200,0,0
2018-10-12,29100,28772.586,29150,377.4140625,327.414,-50,0,1
2018-10-15,29150,28959.344,29200,240.65625,190.656,-50,0,1
2018-10-16,29200,29137.244,30100,962.7558594,62.756,-900,0,1
2018-10-17,30100,29829.771,29450,379.7714844,270.229,650,0,0
2018-10-18,29450,29186.598,29250,63.40234375,263.402,200,0,0
2018-10-19,29250,28640.514,29800,1159.486328,609.486,-550,0,1
2018-10-22,29800,29151.426,29000,151.4257813,648.574,800,0,0
2018-10-23,29000,28609.47,29500,890.5292969,390.53,-500,0,1
2018-10-24,29500,29024.86,28950,74.859375,475.14,550,0,0
2018-10-25,28950,28476.697,27450,1026.697266,473.303,1500,0,0
2018-10-26,27450,27494.836,26550,944.8359375,-44.836,900,1,0
2018-10-29,26550,26773.023,27350,576.9765625,-223.023,-800,0,0
2018-10-30,27350,27199.809,28100,900.1914063,150.191,-750,0,1
2018-10-31,28100,27822.365,27750,72.36523438,277.635,350,0,0
2018-11-01,27750,27894.287,28450,555.7128906,-144.287,-700,0,0
2018-11-02,28450,28289.844,28350,60.15625,160.156,100,0,0
2018-11-05,28350,27978.738,28550,571.2617188,371.262,-200,0,1
2018-11-06,28550,28056.02,28950,893.9804688,493.98,-400,0,1
2018-11-07,28950,28631.137,29500,868.8632813,318.863,-550,0,1
2018-11-08,29500,29175.674,29300,124.3261719,324.326,200,0,0
2018-11-09,29300,28922.701,29400,477.2988281,377.299,-100,0,1
2018-11-12,29400,28878.994,29750,871.0058594,521.006,-350,0,1
2018-11-13,29750,29210.332,30500,1289.667969,539.668,-750,0,1
2018-11-14,30500,30161.924,30100,61.92382813,338.076,400,0,0
2018-11-16,30100,29750.547,30200,449.453125,349.453,-100,0,1
2018-11-19,30200,30044.924,30200,155.0761719,155.076,0,0,0
2018-11-20,30200,29755.684,30450,694.3164063,444.316,-250,0,1
2018-11-21,30450,30003.62,29750,253.6191406,446.38,700,0,0
2018-11-22,29750,29562.85,29500,62.84960938,187.15,250,0,0
2018-11-23,29500,29189.701,29950,760.2988281,310.299,-450,0,1
2018-11-26,29950,29487.725,30150,662.2753906,462.275,-200,0,1
2018-11-27,30150,29716.17,30000,283.8300781,433.83,150,0,0
2018-11-28,30000,29595.72,30300,704.2792969,404.28,-300,0,1
2018-11-29,30300,30033.229,30000,33.22851563,266.771,300,0,0
2018-11-30,30000,29692.246,30850,1157.753906,307.754,-850,0,1
2018-12-03,30850,30414.691,30250,164.6914063,435.309,600,0,0
2018-12-04,30250,30111.93,30400,288.0703125,138.07,-150,0,1
2018-12-05,30400,30002.197,30350,347.8027344,397.803,50,0,0
2018-12-06,30350,29973.756,30300,326.2441406,376.244,50,0,0
2018-12-07,30300,29991.56,30100,108.4394531,308.44,200,0,0
2018-12-10,30100,29706.05,30150,443.9492187,393.95,-50,0,1
2018-12-11,30150,29832.223,30550,717.7773438,317.777,-400,0,1
2018-12-12,30550,30171.363,31150,978.6367188,378.637,-600,0,1
2018-12-13,31150,30763.195,31350,586.8046875,386.805,-200,0,1
2018-12-14,31350,30980.24,30850,130.2402344,369.76,500,0,0
2018-12-17,30850,30673.63,31600,926.3691406,176.37,-750,0,1
2018-12-18,31600,31045.31,32350,1304.689453,554.69,-750,0,1
2018-12-19,32350,31995.496,32850,854.5039063,354.504,-500,0,1
2018-12-20,32850,32279.393,32400,120.6074219,570.607,450,0,0
2018-12-21,32400,32179.443,31950,229.4433594,220.557,450,0,0
2018-12-24,31950,31547.83,31200,347.8300781,402.17,750,0,0
2018-12-26,31200,30840.646,31850,1009.353516,359.354,-650,0,1
2018-12-27,31850,31430.744,31350,80.74414063,419.256,500,0,0
2018-12-28,31350,31235.31,31000,235.3105469,114.69,350,0,0
2019-01-02,31000,30886.266,29950,936.265625,113.734,1050,0,0
2019-01-03,29950,29904.852,29900,4.8515625,45.148,50,0,0
2019-01-04,29900,29470.357,30900,1429.642578,429.643,-1000,0,1
2019-01-07,30900,30510.793,30050,460.7929688,389.207,850,0,0
2019-01-08,30050,30025.232,31150,1124.767578,24.768,-1100,0,1
2019-01-09,31150,30547.195,30300,247.1953125,602.805,850,0,0
2019-01-10,30300,30086.947,31100,1013.052734,213.053,-800,0,1
2019-01-11,31100,30583.133,31600,1016.867188,516.867,-500,0,1
2019-01-14,31600,31096.459,32300,1203.541016,503.541,-700,0,1
2019-01-15,32300,31853.096,32550,696.9042969,446.904,-250,0,1
2019-01-16,32550,32106.932,33550,1443.068359,443.068,-1000,0,1
2019-01-17,33550,33269.668,33600,330.3320313,280.332,-50,0,1
2019-01-18,33600,33255.664,33300,44.3359375,344.336,300,0,0
2019-01-21,33300,32995.8,33250,254.1992188,304.2,50,0,0
2019-01-22,33250,32948.617,34250,1301.382813,301.383,-1000,0,1
2019-01-23,34250,33862.1,34300,437.8984375,387.9,-50,0,1
2019-01-24,34300,34117.98,33850,267.9804688,182.02,450,0,0
2019-01-25,33850,33736.81,34100,363.1914063,113.19,-250,0,1
2019-01-28,34100,33689.93,34000,310.0703125,410.07,100,0,0
2019-01-29,34000,33553.586,34150,596.4140625,446.414,-150,0,1
2019-01-30,34150,33812.605,35150,1337.394531,337.395,-1000,0,1
2019-01-31,35150,34739.45,34000,739.4492188,410.55,1150,0,0
2019-02-01,34000,33921.996,34050,128.0039063,78.004,-50,0,1
2019-02-07,34050,33515.12,33200,315.1210938,534.88,850,0,0
2019-02-08,33200,32900.684,33350,449.3164063,299.316,-150,0,1
2019-02-11,33350,33095.83,33450,354.171875,254.17,-100,0,1
2019-02-12,33450,33030.734,33750,719.265625,419.266,-300,0,1
2019-02-13,33750,33381.76,33700,318.2382813,368.24,50,0,0
2019-02-14,33700,33155.61,33050,105.609375,544.39,650,0,0
2019-02-15,33050,32677.506,33550,872.4941406,372.494,-500,0,1
2019-02-18,33550,33150.965,33150,0.96484375,399.035,400,0,0
2019-02-19,33150,32897.953,33700,802.046875,252.047,-550,0,1
2019-02-20,33700,33307.727,34100,792.2734375,392.273,-400,0,1
2019-02-21,34100,33780.04,33800,19.9609375,319.96,300,0,0
2019-02-22,33800,33505.88,33550,44.12109375,294.12,250,0,0
2019-02-25,33550,33290.945,33850,559.0546875,259.055,-300,0,1
2019-02-26,33850,33371.066,32950,421.0664063,478.934,900,0,0
2019-02-27,32950,32721.428,32150,571.4277344,228.572,800,0,0
2019-02-28,32150,32145.443,31850,295.4433594,4.557,300,0,0
2019-03-04,31850,31697.828,32000,302.171875,152.172,-150,0,1
2019-03-05,32000,31628.143,31900,271.8574219,371.857,100,0,0
2019-03-06,31900,31678.408,31500,178.4082031,221.592,400,0,0
2019-03-07,31500,31379.518,30950,429.5175781,120.482,550,0,0
2019-03-08,30950,30822.977,30850,27.0234375,127.023,100,0,0
2019-03-11,30850,30430.305,31250,819.6953125,419.695,-400,0,1
2019-03-12,31250,30952.156,31600,647.84375,297.844,-350,0,1
2019-03-13,31600,31116.014,31750,633.9863281,483.986,-150,0,1
2019-03-14,31750,31355.156,31850,494.84375,394.844,-100,0,1
2019-03-15,31850,31460.652,32200,739.3476563,389.348,-350,0,1
2019-03-18,32200,31827.938,32100,272.0625,372.062,100,0,0
2019-03-19,32100,31725.715,31450,275.7148438,374.285,650,0,0
2019-03-20,31450,31163.89,31000,163.890625,286.11,450,0,0
2019-03-21,31000,30933.934,30950,16.06640625,66.066,50,0,0
2019-03-22,30950,30786.152,30650,136.1523438,163.848,300,0,0
2019-03-25,30650,30524.883,30800,275.1171875,125.117,-150,0,1
2019-03-26,30800,30632.533,30800,167.4667969,167.467,0,0,0
2019-03-27,30800,30671.97,30200,471.9707031,128.03,600,0,0
2019-03-28,30200,30072.281,30400,327.71875,127.719,-200,0,1
2019-03-29,30400,30085.191,30950,864.8085938,314.809,-550,0,1
2019-04-01,30950,30554.459,30600,45.54101563,395.541,350,0,0
2019-04-02,30600,30409.379,31550,1140.621094,190.621,-950,0,1
2019-04-03,31550,30885.107,31100,214.8925781,664.893,450,0,0
2019-04-04,31100,30752.506,31050,297.4941406,347.494,50,0,0
2019-04-05,31050,30713.482,31000,286.5175781,336.518,50,0,0
2019-04-08,31000,30718.494,30900,181.5058594,281.506,100,0,0
2019-04-09,30900,30592.215,31350,757.7851563,307.785,-450,0,1
2019-04-10,31350,30992.277,31050,57.72265625,357.723,300,0,0
2019-04-11,31050,30964.562,31250,285.4375,85.438,-200,0,1
2019-04-12,31250,30884.86,32350,1465.140625,365.14,-1100,0,1
2019-04-15,32350,31812.754,31850,37.24609375,537.246,500,0,0
2019-04-16,31850,31636.064,31650,13.93554688,213.936,200,0,0
2019-04-17,31650,31382.846,30900,482.8457031,267.154,750,0,0
2019-04-18,30900,30832.781,31150,317.21875,67.219,-250,0,1
2019-04-19,31150,30918.564,31350,431.4355469,231.436,-200,0,1
2019-04-22,31350,31420.592,30950,470.5917969,-70.592,400,1,0
2019-04-23,30950,30779.916,30250,529.9160156,170.084,700,0,0
2019-04-24,30250,30206.74,30100,106.7402344,43.26,150,0,0
2019-04-25,30100,29840.328,29950,109.671875,259.672,150,0,0
2019-04-26,29950,29744.336,30250,505.6640625,205.664,-300,0,1
2019-04-29,30250,29866.477,29600,266.4765625,383.523,650,0,0
2019-04-30,29600,29536.646,29300,236.6464844,63.354,300,0,0
2019-05-02,29300,28983.314,29100,116.6855469,316.686,200,0,0
2019-05-03,29100,28878.17,28600,278.1699219,221.83,500,0,0
2019-05-07,28600,28406.793,28750,343.2070313,193.207,-150,0,1
2019-05-08,28750,28396.004,28100,296.0039063,353.996,650,0,0
2019-05-09,28100,28031.11,28150,118.890625,68.89,-50,0,1
2019-05-10,28150,27921.838,27400,521.8378906,228.162,750,0,0
2019-05-13,27400,27318.752,27850,531.2480469,81.248,-450,0,1
2019-05-14,27850,27426.227,28200,773.7734375,423.773,-350,0,1
2019-05-15,28200,27828.299,27450,378.2988281,371.701,750,0,0
2019-05-16,27450,27330.807,26750,580.8066406,119.193,700,0,0
2019-05-17,26750,26750.455,26450,300.4550781,-0.455,300,1,0
2019-05-20,26450,26308.857,26550,241.1425781,141.143,-100,0,1
2019-05-21,26550,26233.53,26600,366.4707031,316.47,-50,0,1
2019-05-22,26600,26424.852,26150,274.8515625,175.148,450,0,0
2019-05-23,26150,26034.555,25850,184.5546875,115.445,300,0,0
2019-05-24,25850,25799.512,25850,50.48828125,50.488,0,0,0
2019-05-27,25850,25664.574,25800,135.4257813,185.426,50,0,0
2019-05-28,25800,25718.191,25350,368.1914063,81.809,450,0,0
2019-05-29,25350,25326.74,25400,73.25976563,23.26,-50,0,1
2019-05-30,25400,25189.62,25550,360.3808594,210.38,-150,0,1
2019-05-31,25550,25320.188,26200,879.8125,229.812,-650,0,1
2019-06-03,26200,25762.248,26150,387.7519531,437.752,50,0,0
2019-06-04,26150,26006.535,26050,43.46484375,143.465,100,0,0
2019-06-05,26050,25948.72,25800,148.7207031,101.28,250,0,0
2019-06-07,25800,25623.236,26250,626.7636719,176.764,-450,0,1
2019-06-10,26250,25923.02,26750,826.9804688,326.98,-500,0,1
2019-06-11,26750,26441.602,26750,308.3984375,308.398,0,0,0
2019-06-12,26750,26501.854,27050,548.1464844,248.146,-300,0,1
2019-06-13,27050,26610.83,26750,139.1699219,439.17,300,0,0
2019-06-14,26750,26474.258,26950,475.7421875,275.742,-200,0,1
2019-06-17,26950,26674.553,26900,225.4472656,275.447,50,0,0
2019-06-18,26900,26673.295,27250,576.7050781,226.705,-350,0,1
2019-06-19,27250,26953.568,27100,146.4316406,296.432,150,0,0
2019-06-20,27100,26911.898,26700,211.8984375,188.102,400,0,0
2019-06-21,26700,26587.86,26800,212.140625,112.14,-100,0,1
2019-06-24,26800,26520.998,26400,120.9980469,279.002,400,0,0
2019-06-25,26400,26272.85,26800,527.1503906,127.15,-400,0,1
2019-06-26,26800,26437.314,26950,512.6855469,362.686,-150,0,1
2019-06-27,26950,26653.88,26700,46.11914063,296.12,250,0,0
2019-06-28,26700,26484.88,27000,515.1191406,215.12,-300,0,1
2019-07-01,27000,26736.51,27100,363.4902344,263.49,-100,0,1
2019-07-02,27100,26833.326,26650,183.3261719,266.674,450,0,0
2019-07-03,26650,26513.578,27100,586.421875,136.422,-450,0,1
2019-07-04,27100,26724.508,27400,675.4921875,375.492,-300,0,1
2019-07-05,27400,27098.756,26700,398.7558594,301.244,700,0,0
2019-07-08,26700,26589.346,26150,439.3457031,110.654,550,0,0
2019-07-09,26150,25962.652,25900,62.65234375,187.348,250,0,0
2019-07-10,25900,25755.812,25950,194.1875,144.188,-50,0,1
2019-07-11,25950,25886.594,26050,163.40625,63.406,-100,0,1
2019-07-12,26050,25971.596,26000,28.40429688,78.404,50,0,0
2019-07-15,26000,25841.38,25850,8.619140625,158.62,150,0,0
2019-07-16,25850,25661.285,25650,11.28515625,188.715,200,0,0
2019-07-17,25650,25422.695,25200,222.6953125,227.305,450,0,0
2019-07-18,25200,25143.031,25850,706.96875,56.969,-650,0,1
2019-07-19,25850,25519.828,25700,180.171875,330.172,150,0,0
2019-07-22,25700,25560.064,25950,389.9355469,139.936,-250,0,1
2019-07-23,25950,25628.645,25500,128.6445313,321.355,450,0,0
2019-07-24,25500,25382.379,24900,482.3789062,117.621,600,0,0
2019-07-25,24900,24803.762,23950,853.7617188,96.238,950,0,0
2019-07-26,23950,23957.77,23300,657.7695313,-7.77,650,1,0
2019-07-29,23300,23336.576,23650,313.4238281,-36.576,-350,0,0
2019-07-30,23650,23494.441,23850,355.5585938,155.559,-200,0,1
2019-07-31,23850,23796.094,23600,196.09375,53.906,250,0,0
2019-08-01,23600,23573.488,23150,423.4882813,26.512,450,0,0
2019-08-02,23150,23075.143,22300,775.1425781,74.857,850,0,0
2019-08-05,22300,22330.129,21950,380.1289063,-30.129,350,1,0
2019-08-06,21950,21880.887,21450,430.8867188,69.113,500,0,0
2019-08-07,21450,21605.969,21850,244.03125,-155.969,-400,0,0
2019-08-08,21850,21729.676,21900,170.3242188,120.324,-50,0,1
2019-08-09,21900,21897.643,21700,197.6425781,2.357,200,0,0
2019-08-12,21700,21603.598,21900,296.4023438,96.402,-200,0,1
2019-08-13,21900,21898.516,22100,201.484375,1.484,-200,0,1
2019-08-14,22100,22055.986,21550,505.9863281,44.014,550,0,0
2019-08-16,21550,21396.676,22600,1203.324219,153.324,-1050,0,1
2019-08-19,22600,22210.861,22800,589.1386719,389.139,-200,0,1
2019-08-20,22800,22631.684,23050,418.3164063,168.316,-250,0,1
2019-08-21,23050,22787.557,23550,762.4433594,262.443,-500,0,1
2019-08-22,23550,23321.254,23650,328.7460938,228.746,-100,0,1
2019-08-23,23650,23388.395,23400,11.60546875,261.605,250,0,0
2019-08-26,23400,23283.47,23100,183.4707031,116.53,300,0,0
2019-08-27,23100,23028.822,23800,771.1777344,71.178,-700,0,1
2019-08-28,23800,23404.57,24200,795.4296875,395.43,-400,0,1
2019-08-29,24200,23894.654,24500,605.3457031,305.346,-300,0,1
2019-08-30,24500,24205.566,24450,244.4335938,294.434,50,0,0
2019-09-02,24450,24214.648,24500,285.3515625,235.352,-50,0,1
2019-09-03,24500,24225.6,24500,274.4003906,274.4,0,0,0
2019-09-04,24500,24100.16,24300,199.8398438,399.84,200,0,0
2019-09-05,24300,24106.475,24300,193.5253906,193.525,0,0,0
2019-09-06,24300,24143.941,24850,706.0585938,156.059,-550,0,1
2019-09-09,24850,24567.791,25000,432.2089844,282.209,-150,0,1
2019-09-10,25000,24738.924,25250,511.0761719,261.076,-250,0,1
2019-09-11,25250,25170.133,25850,679.8671875,79.867,-600,0,1
2019-09-16,25850,25529.795,25950,420.2050781,320.205,-100,0,1
2019-09-17,25950,25635.355,26000,364.6445313,314.645,-50,0,1
2019-09-18,26000,25700.81,25700,0.810546875,299.19,300,0,0
2019-09-19,25700,25519.742,25950,430.2578125,180.258,-250,0,1
2019-09-20,25950,25631.057,25650,18.94335938,318.943,300,0,0
2019-09-23,25650,25513.416,25750,236.5839844,136.584,-100,0,1
2019-09-24,25750,25474.46,25100,374.4609375,275.54,650,0,0
2019-09-25,25100,25062.91,25050,12.91015625,37.09,50,0,0
2019-09-26,25050,24900.902,24650,250.9023438,149.098,400,0,0
2019-09-27,24650,24674.707,25250,575.2929688,-24.707,-600,0,0
2019-09-30,25250,24862.904,25050,187.0957031,387.096,200,0,0
2019-10-01,25050,24959.145,24200,759.1445312,90.855,850,0,0
2019-10-02,24200,24193.209,24200,6.791015625,6.791,0,0,0
2019-10-04,24200,23955.268,24100,144.7324219,244.732,100,0,0
2019-10-07,24100,23954.432,24050,95.56835937,145.568,50,0,0
2019-10-08,24050,23824.535,23300,524.5351563,225.465,750,0,0
2019-10-10,23300,23276.133,23800,523.8671875,23.867,-500,0,1
2019-10-11,23800,23624.744,25100,1475.255859,175.256,-1300,0,1
2019-10-14,25100,24715.904,25000,284.0957031,384.096,100,0,0
2019-10-15,25000,24932.71,25050,117.2890625,67.29,-50,0,1
2019-10-16,25050,24844.02,24750,94.01953125,205.98,300,0,0
2019-10-17,24750,24605.398,24850,244.6015625,144.602,-100,0,1
2019-10-18,24850,24613.93,24900,286.0703125,236.07,-50,0,1
2019-10-21,24900,24735.135,25100,364.8652344,164.865,-200,0,1
2019-10-22,25100,24891.705,24300,591.7050781,208.295,800,0,0
2019-10-23,24300,24283.244,24400,116.7558594,16.756,-100,0,1
2019-10-24,24400,24124.309,24050,74.30859375,275.691,350,0,0
2019-10-25,24050,23955.164,24100,144.8359375,94.836,-50,0,1
2019-10-28,24100,24090.803,23800,290.8027344,9.197,300,0,0
2019-10-29,23800,23831.172,23550,281.171875,-31.172,250,1,0
2019-10-30,23550,23487.459,23750,262.5410156,62.541,-200,0,1
2019-10-31,23750,23554.127,23900,345.8730469,195.873,-150,0,1
2019-11-01,23900,23639.037,24550,910.9628906,260.963,-650,0,1
2019-11-04,24550,24232.777,24600,367.2226562,317.223,-50,0,1
2019-11-05,24600,24286.654,24600,313.3457031,313.346,0,0,0
2019-11-06,24600,24442.148,24900,457.8515625,157.852,-300,0,1
2019-11-07,24900,24600.955,24850,249.0449219,299.045,50,0,0
2019-11-08,24850,24617.297,24550,67.296875,232.703,300,0,0
2019-11-11,24550,24379.133,24950,570.8671875,170.867,-400,0,1
2019-11-12,24950,24653.621,25150,496.3789062,296.379,-200,0,1
2019-11-13,25150,24954.424,26150,1195.576172,195.576,-1000,0,1
2019-11-15,26150,25868.28,26300,431.7207031,281.72,-150,0,1
2019-11-18,26300,26082.914,25950,132.9140625,217.086,350,0,0
2019-11-19,25950,25719.143,25400,319.1425781,230.857,550,0,0
2019-11-20,25400,25249.168,25150,99.16796875,150.832,250,0,0
2019-11-21,25150,24991.459,24850,141.4589844,158.541,300,0,0
2019-11-22,24850,24744.111,25400,655.8886719,105.889,-550,0,1
2019-11-25,25400,25139.54,25400,260.4609375,260.46,0,0,0
2019-11-26,25400,25108.826,25100,8.826171875,291.174,300,0,0
2019-11-27,25100,24976.11,25050,73.890625,123.89,50,0,0
2019-11-28,25050,24825.248,24550,275.2480469,224.752,500,0,0
2019-11-29,24550,24436.47,24800,363.5292969,113.53,-250,0,1
2019-12-02,24800,24509.295,24550,40.70507813,290.705,250,0,0
2019-12-03,24550,24380.27,23900,480.2695313,169.73,650,0,0
2019-12-04,23900,23783.21,24050,266.7890625,116.79,-150,0,1
2019-12-05,24050,23868.777,24200,331.2226563,181.223,-150,0,1
2019-12-06,24200,24006.627,23950,56.62695313,193.373,250,0,0
2019-12-09,23950,23904.666,23900,4.666015625,45.334,50,0,0
2019-12-10,23900,23761.06,24100,338.9394531,138.94,-200,0,1
2019-12-11,24100,23840.885,24400,559.1152344,259.115,-300,0,1
2019-12-12,24400,24133.393,25100,966.6074219,266.607,-700,0,1
2019-12-13,25100,24722.455,25100,377.5449219,377.545,0,0,0
2019-12-16,25100,24925.76,25200,274.2402344,174.24,-100,0,1
2019-12-17,25200,24894.592,25050,155.4082031,305.408,150,0,0
2019-12-18,25050,24863.121,25300,436.8789062,186.879,-250,0,1
2019-12-19,25300,25002.354,25250,247.6464844,297.646,50,0,0
2019-12-20,25250,25030.83,25250,219.1699219,219.17,0,0,0
2019-12-23,25250,25091.195,25350,258.8046875,158.805,-100,0,1
2019-12-24,25350,25129.973,25600,470.0273438,220.027,-250,0,1
2019-12-26,25600,25342.56,25250,92.56054688,257.44,350,0,0
2019-12-27,25250,24979.535,25000,20.46484375,270.465,250,0,0
2019-12-30,25000,24864.117,24350,514.1171875,135.883,650,0,0
2020-01-02,24350,24295.338,24550,254.6621094,54.662,-200,0,1
2020-01-03,24550,24351.787,23500,851.7871094,198.213,1050,0,0
2020-01-06,23500,23544.385,23650,105.6152344,-44.385,-150,0,0
2020-01-07,23650,23530.994,22500,1030.994141,119.006,1150,0,0
2020-01-08,22500,22592.193,22550,42.19335938,-92.193,-50,0,0
2020-01-09,22550,22504.965,22650,145.0351563,45.035,-100,0,1
2020-01-10,22650,22524.158,22900,375.8417969,125.842,-250,0,1
2020-01-13,22900,22759.783,23550,790.2167969,140.217,-650,0,1
2020-01-14,23550,23239.02,23800,560.9804688,310.98,-250,0,1
2020-01-15,23800,23507.355,23700,192.6445313,292.645,100,0,0
2020-01-16,23700,23478.148,23600,121.8515625,221.852,100,0,0
2020-01-17,23600,23430.031,23600,169.96875,169.969,0,0,0
2020-01-20,23600,23383.79,23800,416.2109375,216.21,-200,0,1
2020-01-21,23800,23652.275,23750,97.72460938,147.725,50,0,0
2020-01-22,23750,23609.795,23500,109.7949219,140.205,250,0,0
2020-01-23,23500,23386.436,22300,1086.435547,113.564,1200,0,0
2020-01-28,22300,22326.963,22600,273.0371094,-26.963,-300,0,0
2020-01-29,22600,22516.973,22400,116.9726562,83.027,200,0,0
2020-01-30,22400,22502.395,21750,752.3945313,-102.395,650,1,0
2020-01-31,21750,22027.11,21400,627.109375,-277.11,350,1,0
2020-02-03,21400,21282.15,22000,717.8496094,117.85,-600,0,1
2020-02-04,22000,21809.53,22000,190.4707031,190.47,0,0,0
2020-02-05,22000,21897.566,23100,1202.433594,102.434,-1100,0,1
2020-02-06,23100,22790.5,23050,259.5,309.5,50,0,0
2020-02-07,23050,22751.342,23000,248.6582031,298.658,50,0,0
2020-02-10,23000,22630.238,23000,369.7617188,369.762,0,0,0
2020-02-11,23000,22738,23400,662,262,-400,0,1
2020-02-12,23400,23064.586,23150,85.4140625,335.414,250,0,0
2020-02-13,23150,22949.86,22900,49.859375,200.14,250,0,0
2020-02-14,22900,22740.69,22900,159.3105469,159.31,0,0,0
2020-02-17,22900,22773.97,22600,173.9707031,126.03,300,0,0
2020-02-18,22600,22565.428,22250,315.4277344,34.572,350,0,0
2020-02-19,22250,22282.182,21950,332.1816406,-32.182,300,1,0
2020-02-20,21950,22043,21350,693,-93,600,1,0
2020-02-21,21350,21403.053,20350,1053.052734,-53.053,1000,1,0
2020-02-24,20350,20502.623,20700,197.3769531,-152.623,-350,0,0
2020-02-25,20700,20560.33,20300,260.3300781,139.67,400,0,0
2020-02-26,20300,20321.252,20400,78.74804688,-21.252,-100,0,0
2020-02-27,20400,20323.238,20050,273.2382813,76.762,350,0,0
2020-02-28,20050,20058.875,19950,108.875,-8.875,100,1,0
2020-03-02,19950,19903.742,20400,496.2578125,46.258,-450,0,1
2020-03-03,20400,20268.176,20500,231.8242188,131.824,-100,0,1
2020-03-04,20500,20320.33,21150,829.6699219,179.67,-650,0,1
2020-03-05,21150,20865.617,20450,415.6171875,284.383,700,0,0
2020-03-06,20450,20444.38,20450,5.619140625,5.62,0,0,0
2020-03-09,20450,20369.973,19750,619.9726563,80.027,700,0,0
2020-03-10,19750,19657.912,19300,357.9121094,92.088,450,0,0
2020-03-11,19300,19410.186,19300,110.1855469,-110.186,0,0,0
2020-03-12,19300,19383.137,17000,2383.136719,-83.137,2300,1,0
2020-03-13,17000,16908.912,16850,58.91210938,91.088,150,0,0
2020-03-16,16850,17202.725,16300,902.7246094,-352.725,550,1,0
2020-03-17,16300,16508.354,14750,1758.353516,-208.354,1550,1,0
2020-03-18,14750,15695.29,12500,3195.290039,-945.29,2250,1,0
2020-03-19,12500,13647.313,13750,102.6865234,-1147.313,-1250,0,0
2020-03-20,13750,13789.793,12050,1739.792969,-39.793,1700,1,0
2020-03-23,12050,12933.505,12800,133.5048828,-883.505,-750,0,0
2020-03-24,12800,13151.599,14150,998.4013672,-351.599,-1350,0,0
2020-03-25,14150,14282.233,14100,182.2333984,-132.233,50,1,0
2020-03-26,14100,14491.488,14750,258.5117188,-391.488,-650,0,0
2020-03-27,14750,14759.349,14800,40.65136719,-9.349,-50,0,0
2020-03-30,14800,14827.254,15300,472.7460938,-27.254,-500,0,0
2020-03-31,15300,15310.595,15200,110.5947266,-10.595,100,1,0
2020-04-01,15200,15331.891,15750,418.109375,-131.891,-550,0,0
2020-04-02,15750,15581.066,15800,218.9335938,168.934,-50,0,1
2020-04-03,15800,15906.478,17050,1143.522461,-106.478,-1250,0,0
2020-04-06,17050,16776.479,17300,523.5214844,273.521,-250,0,1
2020-04-07,17300,17344.205,17550,205.7949219,-44.205,-250,0,0
2020-04-08,17550,17356.387,18100,743.6132813,193.613,-550,0,1
2020-04-09,18100,17752.453,18300,547.546875,347.547,-200,0,1
2020-04-10,18300,17855.031,17850,5.03125,444.969,450,0,0
2020-04-13,17850,17690.25,18200,509.75,159.75,-350,0,1
2020-04-14,18200,17830.574,18000,169.4257813,369.426,200,0,0
2020-04-16,18000,17697.568,18350,652.4316406,302.432,-350,0,1
2020-04-17,18350,18092.283,17950,142.2832031,257.717,400,0,0
2020-04-20,17950,18027.893,17900,127.8925781,-77.893,50,1,0
2020-04-21,17900,18456.23,17800,656.2304688,-556.23,100,1,0
2020-04-22,17800,17546.805,18450,903.1953125,253.195,-650,0,1
2020-04-23,18450,18272.238,18450,177.7617188,177.762,0,0,0
2020-04-24,18450,18625.672,18950,324.328125,-175.672,-500,0,0
2020-04-27,18950,18930.117,19400,469.8828125,19.883,-450,0,1
2020-04-28,19400,19264.371,20700,1435.628906,135.629,-1300,0,1
2020-04-29,20700,20259.05,19100,1159.050781,440.95,1600,0,0
2020-05-04,19100,18999.916,18950,49.91601563,100.084,150,0,0
2020-05-06,18950,18912.441,18950,37.55859375,37.559,0,0,0
2020-05-07,18950,18751.676,19200,448.3242188,198.324,-250,0,1
2020-05-08,19200,19033.896,19200,166.1035156,166.104,0,0,0
2020-05-11,19200,19244.383,18800,444.3828125,-44.383,400,1,0
2020-05-12,18800,18836.61,19150,313.390625,-36.61,-350,0,0
2020-05-13,19150,18913.8,18900,13.80078125,236.2,250,0,0
2020-05-14,18900,18789.988,18900,110.0117188,110.012,0,0,0
2020-05-15,18900,18834.379,19250,415.6210938,65.621,-350,0,1
2020-05-18,19250,19066.256,19400,333.7441406,183.744,-150,0,1
2020-05-19,19400,19287.871,19300,12.12890625,112.129,100,0,0
2020-05-20,19300,19096.496,19650,553.5039063,203.504,-350,0,1
2020-05-21,19650,19366.4,19550,183.5996094,283.6,100,0,0
2020-05-22,19550,19308.717,19600,291.2832031,241.283,-50,0,1
2020-05-25,19600,19441.951,19650,208.0488281,158.049,-50,0,1
2020-05-26,19650,19715.576,20200,484.4238281,-65.576,-550,0,0
2020-05-27,20200,19931.627,20050,118.3730469,268.373,150,0,0
2020-05-28,20050,19942.781,20100,157.21875,107.219,-50,0,1
2020-05-29,20100,19920.316,20400,479.6835938,179.684,-300,0,1
2020-06-01,20400,20211.871,20400,188.1289063,188.129,0,0,0
2020-06-02,20400,20333.842,21050,716.1582031,66.158,-650,0,1
2020-06-03,21050,20933.514,20900,33.51367188,116.486,150,0,0
2020-06-04,20900,20871.703,21200,328.296875,28.297,-300,0,1
2020-06-05,21200,20875.58,22850,1974.419922,324.42,-1650,0,1
2020-06-08,22850,22741.314,28950,6208.685547,108.686,-6100,0,1
2020-06-09,28950,29027.045,27050,1977.044922,-77.045,1900,1,0
2020-06-10,27050,27811.059,25350,2461.058594,-761.059,1700,1,0
2020-06-11,25350,25485.18,24650,835.1796875,-135.18,700,1,0
2020-06-12,24650,24828.018,22450,2378.017578,-178.018,2200,1,0
2020-06-15,22450,23937.084,24000,62.91601563,-1487.084,-1550,0,0
2020-06-16,24000,24555.793,24200,355.7929687,-555.793,-200,0,0
2020-06-17,24200,25297.969,23250,2047.96875,-1097.969,950,1,0
2020-06-18,23250,22834.314,23150,315.6855469,415.686,100,0,0
2020-06-19,23150,23017.01,22700,317.0097656,132.99,450,0,0
2020-06-22,22700,22759.385,23450,690.6152344,-59.385,-750,0,0
2020-06-23,23450,22722.924,23000,277.0761719,727.076,450,0,0
2020-06-24,23000,22853.385,22350,503.3847656,146.615,650,0,0
2020-06-25,22350,21891.871,22000,108.1289063,458.129,350,0,0
2020-06-26,22000,21842.826,21450,392.8261719,157.174,550,0,0
2020-06-29,21450,21686.227,22150,463.7734375,-236.227,-700,0,0
2020-06-30,22150,21937.7,22400,462.3007813,212.3,-250,0,1
2020-07-01,22400,21939.164,22550,610.8359375,460.836,-150,0,1
2020-07-02,22550,22040.4,22500,459.5996094,509.6,50,0,0
2020-07-03,22500,21604.355,23000,1395.644531,895.645,-500,0,1
2020-07-06,23000,21602.393,22800,1197.607422,1397.607,200,0,0
2020-07-07,22800,22385.283,22500,114.7167969,414.717,300,0,0
2020-07-08,22500,22836.828,23350,513.171875,-336.828,-850,0,0
2020-07-09,23350,23281.049,22650,631.0488281,68.951,700,0,0
2020-07-10,22650,22724.4,23350,625.5996094,-74.4,-700,0,0
2020-07-13,23350,22753.088,23550,796.9121094,596.912,-200,0,1
2020-07-14,23550,23131.14,24150,1018.859375,418.86,-600,0,1
2020-07-15,24150,23839.025,23550,289.0253906,310.975,600,0,0
2020-07-16,23550,23540.969,23650,109.03125,9.031,-100,0,1
2020-07-17,23650,23484.953,23550,65.046875,165.047,100,0,0
2020-07-20,23550,23195.37,24000,804.6308594,354.63,-450,0,1
2020-07-21,24000,23673.742,23850,176.2578125,326.258,150,0,0
2020-07-22,23850,23796.994,23250,546.9941406,53.006,600,0,0
2020-07-23,23250,23183.775,22850,333.7753906,66.225,400,0,0
2020-07-24,22850,22713.713,23850,1136.287109,136.287,-1000,0,1
2020-07-27,23850,23578.635,23800,221.3652344,271.365,50,0,0
2020-07-28,23800,23707.34,25750,2042.660156,92.66,-1950,0,1
2020-07-29,25750,26375.11,26200,175.109375,-625.11,-450,0,0
2020-07-30,26200,26037.277,25400,637.2773438,162.723,800,0,0
2020-07-31,25400,25497.29,24550,947.2890625,-97.29,850,1,0
2020-08-03,24550,24556.316,25100,543.6835938,-6.316,-550,0,0
2020-08-04,25100,25177.262,25050,127.2617188,-77.262,50,1,0
2020-08-05,25050,25131.902,25200,68.09765625,-81.902,-150,0,0
2020-08-06,25200,25351.744,24800,551.7441406,-151.744,400,1,0
2020-08-07,24800,24504.604,25500,995.3964844,295.396,-700,0,1
2020-08-10,25500,24895.277,25550,654.7226563,604.723,-50,0,1
2020-08-11,25550,25239.912,26150,910.0878906,310.088,-600,0,1
2020-08-12,26150,25465.941,25850,384.0585937,684.059,300,0,0
2020-08-13,25850,25688.887,26450,761.1132813,161.113,-600,0,1
2020-08-14,26450,26098.768,25650,448.7675781,351.232,800,0,0
2020-08-18,25650,25923.672,25950,26.328125,-273.672,-300,0,0
2020-08-19,25950,25813.676,24700,1113.675781,136.324,1250,0,0
2020-08-20,24700,24968.152,25250,281.8476563,-268.152,-550,0,0
2020-08-21,25250,24878.498,25350,471.5019531,371.502,-100,0,1
2020-08-24,25350,25064.135,26650,1585.865234,285.865,-1300,0,1
2020-08-25,26650,26033.703,26500,466.296875,616.297,150,0,0
2020-08-26,26500,25997.615,26000,2.384765625,502.385,500,0,0
2020-08-27,26000,25668.902,26100,431.0976563,331.098,-100,0,1
2020-08-28,26100,25838.156,27500,1661.84375,261.844,-1400,0,1
2020-08-31,27500,27185.43,27400,214.5703125,314.57,100,0,0
2020-09-01,27400,27105.828,27850,744.171875,294.172,-450,0,1
2020-09-02,27850,27562.652,29500,1937.347656,287.348,-1650,0,1
2020-09-03,29500,28865.434,32200,3334.566406,634.566,-2700,0,1
2020-09-04,32200,31842.26,32100,257.7402344,357.74,100,0,0
2020-09-07,32100,32763.012,30950,1813.011719,-663.012,1150,1,0
2020-09-08,30950,30960.69,30200,760.6894531,-10.69,750,1,0
2020-09-09,30200,30186.314,30150,36.31445313,13.686,50,0,0
2020-09-10,30150,30137.166,28750,1387.166016,12.834,1400,0,0
2020-09-11,28750,29078.658,28000,1078.658203,-328.658,750,1,0
2020-09-14,28000,28391.371,27050,1341.371094,-391.371,950,1,0
2020-09-15,27050,26955.47,27200,244.5292969,94.53,-150,0,1
2020-09-16,27200,26663.152,26900,236.8476563,536.848,300,0,0
2020-09-17,26900,26781.238,26750,31.23828125,118.762,150,0,0
2020-09-18,26750,26299.002,26300,0.998046875,450.998,450,0,0
2020-09-21,26300,26173.79,25100,1073.789063,126.21,1200,0,0
2020-09-22,25100,24750.875,24700,50.875,349.125,400,0,0
2020-09-23,24700,24371.86,24050,321.859375,328.14,650,0,0
2020-09-24,24050,23998.03,23900,98.02929688,51.97,150,0,0
2020-09-25,23900,23635.79,24650,1014.210938,264.21,-750,0,1
2020-09-28,24650,23964.94,25150,1185.060547,685.06,-500,0,1
2020-09-29,25150,24730.266,26500,1769.734375,419.734,-1350,0,1
2020-10-05,26500,25631.148,26250,618.8515625,868.852,250,0,0
2020-10-06,26250,25534.307,26050,515.6933594,715.693,200,0,0
2020-10-07,26050,25486.424,26550,1063.576172,563.576,-500,0,1
2020-10-08,26550,26337.234,27200,862.765625,212.766,-650,0,1
2020-10-12,27200,26980.996,26850,130.9960938,219.004,350,0,0
2020-10-13,26850,26766.98,26650,116.9804688,83.02,200,0,0
2020-10-14,26650,26387.486,26050,337.4863281,262.514,600,0,0
2020-10-15,26050,25874.74,25600,274.7402344,175.26,450,0,0
2020-10-16,25600,25454.293,25150,304.2929688,145.707,450,0,0
2020-10-19,25150,25157.807,25150,7.806640625,-7.807,0,0,0
2020-10-20,25150,24925.78,26400,1474.220703,224.22,-1250,0,1
2020-10-21,26400,25919.582,26450,530.4179688,480.418,-50,0,1
2020-10-22,26450,26074.252,26150,75.74804688,375.748,300,0,0
2020-10-23,26150,25868.906,25550,318.90625,281.094,600,0,0
2020-10-26,25550,25241.156,25450,208.84375,308.844,100,0,0
2020-10-27,25450,25063.52,25500,436.4804688,386.48,-50,0,1
2020-10-28,25500,25041.814,25100,58.18554688,458.186,400,0,0
2020-10-29,25100,24762.871,24050,712.8710938,337.129,1050,0,0
2020-10-30,24050,23985.266,24600,614.734375,64.734,-550,0,1
2020-11-02,24600,24196.04,25250,1053.960938,403.96,-650,0,1
2020-11-03,25250,24907.453,24600,307.453125,342.547,650,0,0
2020-11-04,24600,24674.746,25600,925.2539063,-74.746,-1000,0,0
2020-11-05,25600,25269.543,25450,180.4570313,330.457,150,0,0
2020-11-06,25450,25271.812,26200,928.1875,178.188,-750,0,1
2020-11-09,26200,25746.455,26400,653.5449219,453.545,-200,0,1
2020-11-10,26400,26051.229,26750,698.7714844,348.771,-350,0,1
2020-11-11,26750,26495.865,26150,345.8652344,254.135,600,0,0
2020-11-12,26150,25977.684,26650,672.3164063,172.316,-500,0,1
2020-11-13,26650,26146.018,27050,903.9824219,503.982,-400,0,1
2020-11-16,27050,26892.633,26800,92.6328125,157.367,250,0,0
2020-11-17,26800,26791.584,26950,158.4160156,8.416,-150,0,1
2020-11-18,26950,26743.158,26150,593.1582031,206.842,800,0,0
2020-11-19,26150,26119.959,26150,30.04101563,30.041,0,0,0
2020-11-20,26150,26028.293,26550,521.7070312,121.707,-400,0,1
2020-11-23,26550,26280.896,26800,519.1035156,269.104,-250,0,1
2020-11-24,26800,26649.621,26650,0.37890625,150.379,150,0,0
2020-11-25,26650,26440.758,26450,9.2421875,209.242,200,0,0
2020-11-26,26450,26087.03,26350,262.9707031,362.97,100,0,0
2020-11-27,26350,26028.064,25800,228.0644531,321.936,550,0,0
2020-11-30,25800,25602.865,26100,497.1347656,197.135,-300,0,1
2020-12-01,26100,25690.652,26700,1009.347656,409.348,-600,0,1
2020-12-02,26700,26283.854,26600,316.1464844,416.146,100,0,0
2020-12-03,26600,26210.512,26250,39.48828125,389.488,350,0,0
2020-12-04,26250,26025.066,25900,125.0664063,224.934,350,0,0
2020-12-07,25900,25585.664,25650,64.3359375,314.336,250,0,0
2020-12-08,25650,25413.518,26100,686.4824219,236.482,-450,0,1
2020-12-09,26100,25725.164,25800,74.8359375,374.836,300,0,0
2020-12-10,25800,25586.717,26550,963.2832031,213.283,-750,0,1
2020-12-11,26550,26118.076,26200,81.92382813,431.924,350,0,0
2020-12-14,26200,26104.729,26250,145.2714844,95.271,-50,0,1
2020-12-15,26250,25875.205,26700,824.7949219,374.795,-450,0,1
2020-12-16,26700,26359.725,26550,190.2753906,340.275,150,0,0
2020-12-17,26550,26356.309,26400,43.69140625,193.691,150,0,0
2020-12-18,26400,26253.436,26550,296.5644531,146.564,-150,0,1
2020-12-21,26550,26134.508,26200,65.4921875,415.492,350,0,0
2020-12-22,26200,25969.174,26800,830.8261719,230.826,-600,0,1
2020-12-23,26800,26414.926,27950,1535.074219,385.074,-1150,0,1
2020-12-24,27950,27736.686,27900,163.3144531,213.314,50,0,0
2020-12-28,27900,27766.592,27850,83.40820313,133.408,50,0,0
2020-12-29,27850,27631.572,28300,668.4277344,218.428,-450,0,1
2020-12-30,28300,27759.178,29350,1590.822266,540.822,-1050,0,1
,,,,,,,48,436
